111111111
100S00001
100000001
10000S001
111111111