222222222
200000002
2000S0002
200000002
222222222