1111111111111
1000000000001
1000000000001
1000000000001
1000110000001
1000001100001
100001S000001
1110000000001
1111111111111