111111111111111111111111
100000000000000000000001
100000000000000000000001
100001000000000000100001
100000000000000000000001
100000010000000100000001
100000000000000000000001
100000000100010000000001
100000000000000000000001
100000000S00000000000001
100000000001000000000001
100000000000000000000001
100000001000010000000001
100000010000000000000001
100000000000010000000001
100000010000000000000001
100000000000000000000001
100000000000000000000001
100000010000000100000001
100000000000000000000001
100001000000000000100001
100000000000000000000001
100000000000000000000001
111111111111111111111111
